10 8
1 0 3 4 2 1 0 4 3 2
2 2 1 0 1 4 3 0 2 4
0 4 3 1 0 2 1 4 3 2
3 2 1 4 3 0 2 1 0 4
1 0 3 2 1 4 3 0 2 4
4 3 0 1 2 1 4 3 2 0
0 2 1 3 4 2 1 0 4 3
1 4 3 0 2 1 0 4 3 2